{
  "id": "test-arena-walls",
  "name": "Test Arena (walls + jumpthru + spike)",
  "width": 30,
  "height": 17,
  "rows": [
    "..............................",
    "..P........................P..",
    "..............................",
    "..............................",
    "..............................",
    "..............................",
    "..............................",
    ".......----------------.......",
    "..............................",
    "..............................",
    "##..........................##",
    "##..........................##",
    "##..........................##",
    "##..........................##",
    "##..........................##",
    "##............^.............##",
    "##############################"
  ]
}
