{
  "id": "test-arena",
  "name": "Test Arena",
  "width": 30,
  "height": 17,
  "rows": [
    "..............................",
    "..P........................P..",
    "..............................",
    "..............................",
    "..............................",
    "..............................",
    "..............................",
    "..............................",
    "......----........----........",
    "..............................",
    "..............................",
    "..........C........C..........",
    "..............................",
    "..............................",
    "..P........................P..",
    "..............................",
    "##############################"
  ]
}
