{
  "id": "arena-02",
  "name": "Arena 02 — Quad Spawn",
  "width": 30,
  "height": 17,
  "rows": [
    "..............................",
    "..............................",
    "....P....................P....",
    "..............................",
    "..............................",
    ".......C..............C.......",
    "..............................",
    ".........------------.........",
    "..............................",
    "..............................",
    "........P............P........",
    "..............................",
    "..............C...............",
    "##------..............------##",
    "##..........................##",
    "##............^.............##",
    "##############################"
  ]
}
