{
  "id": "old-temple",
  "name": "Old Temple",
  "theme": "old-temple",
  "width": 30,
  "height": 17,
  "rows": [
    "..............................",
    ".P..........................P.",
    "...---......----........---...",
    "..............................",
    "......----........-----.......",
    "...........C.....C............",
    "..####..............####......",
    "..####..............####......",
    "....-------......-------......",
    "..............................",
    ".....----..............----...",
    "...........----------.........",
    "............C......C..........",
    ".....P................P.......",
    "..---..^^......^^......^^---..",
    "##..........................##",
    "##############################"
  ]
}
