{
  "id": "sacred-grove",
  "name": "Sacred Grove",
  "theme": "sacred-grove",
  "width": 30,
  "height": 17,
  "rows": [
    "..............................",
    "..P........................P..",
    "..............................",
    "....-------..........-------..",
    "..............................",
    "..........................C...",
    "...C..........................",
    "............----------........",
    "..............................",
    ".......P..............P.......",
    "..............................",
    "....------............------..",
    "..............................",
    "##..........................##",
    "##..........................##",
    "##............^^............##",
    "##############################"
  ]
}
