{
  "id": "twin-spires",
  "name": "Twin Spires",
  "theme": "twin-spires",
  "width": 30,
  "height": 17,
  "rows": [
    "..............................",
    ".P..........................P.",
    "..............................",
    "###--..............------..###",
    "###..................C.....###",
    "###...........................",
    "##C................-------..##",
    "##.....C......................",
    "##..........................##",
    "##.................---------##",
    "##.....------.................",
    "##........P..........P......##",
    "##.........................###",
    "##---------..........---------",
    "##..........................##",
    "##............^^............##",
    "##############################"
  ]
}
